NO ./path_to_the_north_texture
SO ./path_to_the_south_texture
WE ./path_to_the_west_texture
EA ./path_to_the_east_texture

F 220,100,0
C 225,30,0

111111111111111111111111111111
11N0010000000000111011111111
1110010111111100000000111111111
1100000111110000111000111111
1111001111100111111100111111
1111001111110111111100111111
11110011111100111100000111111
11110000111110111111110111111
111100011111000000001111111111111
1111111111111111111111111111