NO assets/sprites/north_wall.xpm
SO assets/sprites/south_wall.xpm
EA assets/sprites/east_wall.xpm
WE assets/sprites/west_wall.xpm

C 53,41,34
F 45,33,27

11111
11001
10N01
11111