NO cat_textures/NORTH.png
SO cat_textures/SOUTH.png
EA cat_textures/EAST.png
WE cat_textures/WEST.png

C 235,247,255
F 140,119,117

  111111111111111111111111
1100000N000011
100001101100001111111
111111111111111